%%%%%%%%%%%%%%%%
%E.C...D...C...%
%%%%%%%%%%%%%%%%